####################
#..............#...#
#..............#...#
#....#########.##.##
#....#.#..#..#.....#
#......##.#..#.....#
#....#.......#.....#
#....#########.....#
#..................#
#..................#
#..............#####
#..................#
#..............#...#
#..............#...#
####################