########################################
#..............#...##..............#...#
#..............#...##..............#...#
#....#########.##.###....#########.##.##
#....#.#..#..#.....##....#.#..#..#.....#
#......##.#..#.....##......##.#..#.....#
#....#.......#.....##....#.......#.....#
#....#########.....##....#########.....#
#.....#............##..#...............#
#.....#................#...............#
#.....#.....#..######..#....#......#####
#.....#.....#......##..#....#..........#
#.....#.....#..#...##..######......#...#
#.....#.....#..#...##..#...........#...#
#.....#######..#...##..#...........#...#
#..............#...##..#...........#...#
#..............#...##..............#...#
#....#########.##.###....#########.##.##
#....#.#..#..#.....##....#.#..#..#.....#
#......##.#..#.....##......##.#..#.....#
#....#.......#.....##....#.......#.....#
#....#########.....##....#########.....#
#..................##..................#
#..................##..................#
#..............######..............#####
#..................##..................#
#..............#...##..............#...#
#..............#...................#...#
########################################
